//MAP CONVERTED BY dmm2tgm.py THIS HEADER COMMENT PREVENTS RECONVERSION, DO NOT REMOVE
"a" = (
/turf/space,
/area/space)
"i" = (
/turf/unsimulated/floor/red/side{
	dir = 8
	},
/area/space)
"k" = (
/turf/unsimulated/wall/auto/supernorn,
/area/space)
"l" = (
/turf/unsimulated/floor/red/corner{
	dir = 1
	},
/area/space)
"s" = (
/turf/unsimulated/floor/red/side{
	dir = 6
	},
/area/space)
"t" = (
/turf/unsimulated/floor/red/side{
	dir = 10
	},
/area/space)
"u" = (
/turf/unsimulated/floor/orangeblack,
/area/space)
"A" = (
/turf/unsimulated/floor/red/side{
	dir = 9
	},
/area/space)
"B" = (
/turf/unsimulated/floor/red/side{
	dir = 4
	},
/area/space)
"D" = (
/turf/unsimulated/floor/red/side{
	dir = 5
	},
/area/space)
"L" = (
/turf/unsimulated/floor{
	icon_state = "floor"
	},
/area/space)
"M" = (
/turf/unsimulated/floor/red/corner{
	dir = 8
	},
/area/space)
"N" = (
/turf/unsimulated/floor/neutral,
/area/space)
"O" = (
/turf/unsimulated/floor/red/side,
/area/space)
"T" = (
/turf/unsimulated/floor/red/side{
	dir = 1
	},
/area/space)
"U" = (
/turf/unsimulated/floor/plating,
/area/space)
"W" = (
/turf/unsimulated/floor/sanitary/white,
/area/space)
"Z" = (
/turf/unsimulated/floor/grey,
/area/space)

(1,1,1) = {"
a
a
a
a
a
a
a
a
a
a
a
a
a
a
a
a
a
a
a
a
a
a
a
a
a
a
a
a
a
a
a
a
a
a
a
a
a
a
a
a
"}
(2,1,1) = {"
a
a
a
a
a
a
a
a
a
a
a
a
a
a
a
a
a
a
a
a
a
a
a
a
a
a
a
a
a
a
a
a
a
a
a
a
a
a
a
a
"}
(3,1,1) = {"
a
a
a
a
a
a
a
a
a
a
a
a
a
a
a
a
a
a
a
a
a
a
a
a
a
a
a
a
a
a
a
a
a
a
a
a
a
a
a
a
"}
(4,1,1) = {"
a
a
a
a
a
a
a
a
a
a
a
a
a
a
a
a
a
a
a
a
a
a
a
a
a
a
a
a
a
a
a
a
a
a
a
a
a
a
a
a
"}
(5,1,1) = {"
a
a
a
a
a
a
a
a
a
a
a
a
a
a
a
a
a
a
a
a
a
a
a
a
a
a
a
a
a
a
a
a
a
a
a
a
a
a
a
a
"}
(6,1,1) = {"
a
a
a
a
a
a
a
a
a
a
a
a
a
a
a
a
a
a
a
a
a
a
a
a
a
a
a
a
a
a
a
a
a
a
a
a
a
a
a
a
"}
(7,1,1) = {"
a
a
a
a
a
a
a
a
a
a
a
a
a
a
a
a
a
a
a
a
a
a
a
a
a
a
k
k
k
k
k
k
k
k
a
a
a
a
a
a
"}
(8,1,1) = {"
a
a
a
a
a
a
a
a
a
a
a
a
a
a
a
a
a
a
a
a
a
a
a
a
a
a
k
L
L
L
L
L
L
k
a
a
a
a
a
a
"}
(9,1,1) = {"
a
a
a
a
a
a
a
a
a
a
k
k
a
k
k
k
k
k
k
a
a
a
a
a
a
a
k
L
L
L
L
L
L
k
a
a
a
a
a
a
"}
(10,1,1) = {"
a
a
a
a
a
a
a
a
k
k
k
a
k
k
L
L
L
L
k
a
a
a
a
a
a
a
k
L
L
L
L
L
L
k
a
a
a
a
a
a
"}
(11,1,1) = {"
a
a
a
k
k
a
a
a
k
a
a
a
a
k
L
L
L
L
k
L
L
L
L
L
L
L
k
L
L
L
L
L
L
k
a
a
a
a
a
a
"}
(12,1,1) = {"
a
a
a
k
k
k
k
k
k
a
a
a
a
k
L
L
L
L
k
k
k
k
k
N
N
N
k
L
L
L
L
L
L
k
k
k
k
k
k
a
"}
(13,1,1) = {"
a
a
a
a
k
a
a
a
a
a
a
a
a
k
k
k
L
k
k
A
i
t
k
N
N
N
k
k
k
L
L
L
L
L
L
L
L
L
k
a
"}
(14,1,1) = {"
a
a
a
a
k
k
a
a
a
a
a
a
a
a
U
A
i
t
k
T
L
O
U
N
N
N
N
N
k
L
L
L
L
L
L
L
L
L
k
a
"}
(15,1,1) = {"
a
a
a
a
a
k
a
a
a
a
a
a
a
a
U
T
L
O
k
T
L
O
U
N
N
N
N
N
k
L
L
L
L
L
L
L
L
L
k
a
"}
(16,1,1) = {"
a
a
a
a
k
k
a
a
a
a
a
a
a
a
k
T
L
M
i
l
L
O
L
N
N
N
N
N
k
L
L
L
L
L
L
L
L
L
k
a
"}
(17,1,1) = {"
a
a
a
k
a
a
a
a
a
a
a
a
a
a
k
T
L
L
L
L
L
O
U
N
N
N
N
N
k
L
L
L
L
L
L
L
L
L
k
a
"}
(18,1,1) = {"
a
a
k
k
a
a
a
a
a
a
a
a
a
a
U
T
L
L
L
L
L
O
U
N
N
N
k
k
k
k
k
L
L
L
L
L
k
k
k
a
"}
(19,1,1) = {"
a
a
a
a
k
k
a
a
a
a
a
a
a
a
U
D
B
B
B
B
B
s
k
N
N
N
k
L
L
L
L
L
L
L
L
L
L
L
k
a
"}
(20,1,1) = {"
a
a
a
k
k
k
a
a
a
a
a
a
a
a
k
k
k
U
k
k
U
k
k
N
N
N
k
L
L
L
L
L
L
L
L
L
L
L
k
a
"}
(21,1,1) = {"
a
a
a
k
k
a
a
a
a
a
a
a
a
a
a
a
k
L
L
L
L
L
k
N
N
N
N
L
L
L
L
L
L
L
L
L
L
L
k
a
"}
(22,1,1) = {"
a
a
a
a
k
a
a
a
a
a
a
a
a
k
k
k
k
L
k
L
L
L
k
N
N
N
U
L
L
L
L
L
L
L
L
L
L
L
k
a
"}
(23,1,1) = {"
a
a
a
k
k
a
a
a
a
a
a
a
a
k
u
u
k
L
k
L
L
L
L
N
N
N
N
L
L
L
L
L
L
L
L
L
L
L
k
a
"}
(24,1,1) = {"
a
a
a
k
a
a
a
a
a
a
a
a
a
Z
u
u
Z
L
k
L
L
L
k
N
N
N
k
L
L
L
L
L
L
L
L
L
L
L
k
a
"}
(25,1,1) = {"
a
a
k
k
a
a
a
a
a
a
a
a
a
k
u
u
k
L
k
L
L
L
k
N
N
N
U
L
L
L
L
L
L
L
L
L
L
L
k
a
"}
(26,1,1) = {"
a
a
a
k
k
a
a
a
a
a
k
U
U
k
k
k
k
L
k
k
k
k
k
N
N
N
U
L
L
L
L
L
L
L
L
L
L
L
k
a
"}
(27,1,1) = {"
a
a
a
a
a
k
k
a
a
a
k
Z
Z
Z
Z
Z
L
L
L
L
L
L
L
N
N
N
U
L
L
L
L
L
L
L
L
L
L
L
k
a
"}
(28,1,1) = {"
a
a
a
a
a
a
k
k
a
a
Z
Z
Z
Z
Z
Z
L
L
L
L
L
L
U
N
N
N
k
L
L
L
L
L
L
L
L
L
L
L
k
a
"}
(29,1,1) = {"
a
a
a
a
a
a
a
k
a
a
k
Z
Z
Z
Z
Z
L
L
L
L
L
L
L
N
N
N
k
k
k
k
k
k
L
L
L
L
L
L
k
a
"}
(30,1,1) = {"
a
a
a
a
a
a
k
k
a
a
U
Z
Z
Z
Z
Z
k
L
L
k
L
L
k
N
N
N
N
W
W
W
W
k
L
L
L
L
L
L
k
a
"}
(31,1,1) = {"
a
a
a
a
a
k
k
a
a
a
k
Z
Z
Z
Z
Z
k
L
L
k
L
L
k
N
N
N
k
W
W
W
W
k
k
k
L
k
L
k
k
k
"}
(32,1,1) = {"
a
a
a
a
a
k
a
a
a
a
Z
Z
Z
Z
Z
Z
k
L
L
k
L
L
k
N
N
N
k
k
k
k
k
k
k
k
N
N
N
N
N
N
"}
(33,1,1) = {"
a
a
a
a
a
a
a
a
a
a
k
Z
Z
Z
Z
Z
k
k
k
k
k
k
k
N
N
N
k
W
W
W
W
k
U
k
N
N
N
N
N
N
"}
(34,1,1) = {"
a
a
a
a
a
a
a
a
a
a
k
k
k
Z
Z
Z
Z
Z
Z
Z
Z
Z
k
N
N
N
N
W
W
W
W
k
U
k
N
N
N
N
N
N
"}
(35,1,1) = {"
a
a
a
a
a
a
a
a
a
a
a
a
k
Z
Z
Z
Z
Z
Z
Z
Z
Z
k
N
N
N
k
k
k
k
k
k
U
k
N
N
N
k
k
k
"}
(36,1,1) = {"
a
a
a
a
a
a
a
a
a
a
a
a
U
Z
Z
Z
Z
Z
Z
Z
Z
Z
k
N
N
N
k
U
U
U
U
U
U
k
N
N
N
k
a
a
"}
(37,1,1) = {"
a
a
a
a
a
a
a
a
a
a
a
a
U
Z
Z
Z
Z
Z
Z
Z
Z
Z
k
N
N
N
k
U
U
U
U
U
U
k
N
N
N
k
a
a
"}
(38,1,1) = {"
a
a
a
a
a
a
a
a
a
a
a
a
k
Z
Z
Z
Z
Z
Z
Z
Z
Z
k
N
N
N
k
U
U
U
U
U
U
k
N
N
N
k
a
a
"}
(39,1,1) = {"
a
a
a
a
a
a
a
a
a
a
a
a
k
k
k
k
k
k
k
k
k
k
k
N
N
N
k
U
U
U
k
U
U
k
N
N
N
k
a
a
"}
(40,1,1) = {"
a
a
a
a
a
a
a
a
a
a
a
a
a
a
a
a
a
a
a
a
a
a
a
N
N
N
k
U
U
U
k
U
U
k
N
N
N
k
a
a
"}
